; 0
##########
##########
#######  #
### .# #.#
#     .  #
# #  $ $ #
# #####  #
##### $$.#
### @    #
##########