; 10
##########
##########
##########
####.#####
##  $ ####
## # $.###
## # #####
## # #####
##   @####
##########