; 8 Maybe with more iterations...
##########
##########
# . . . ##
#   $   ##
#   $   ##
#   $   ##
#   @   ##
##########
##########
##########