; 7
##########
#### #####
####.#####
#### #####
####$#####
#### $ . #
#### #####
#### #####
#### @####
##########