; 5
##########
##########
##########
####.#####
####$#####
#### $.###
#### #####
#### #####
#### @####
##########