; 0
##########
##########
#####.####
##### ####
##### ####
##### ####
##### ####
#####$####
#####@####
##########