; 8
##########
##########
#   .   ##
#   $   ##
#. $@$ .##
#   $   ##
#   .   ##
##########
##########
##########