; 0
##########
#@ #######
#.$#######
#   ######
#.$ ######
#  #######
# $ ######
#$ . #####
# .  #####
##########