; 0
##########
##########
##########
##########
##########
##########
#####.####
#####$####
#####@####
##########

; 1
##########
##########
##########
##########
##########
#####.####
##### ####
#####$####
#####@####
##########

; 2
##########
##########
#####.####
##### ####
##### ####
##### ####
##### ####
#####$####
#####@####
##########

; 3
##########
##########
##########
##########
##########
##########
##########
#### $.###
#### @####
##########

; 4
##########
##########
##########
##########
##########
#### $.###
#### #####
#### #####
#### @####
##########

; 5
##########
##########
##########
####.#####
####$#####
#### $.###
#### #####
#### #####
#### @####
##########

; 6
##########
##########
####.#####
#### #####
####$#####
#### $ .##
#### #####
#### #####
#### @####
##########

; 7
##########
#### #####
####.#####
#### #####
####$#####
#### $ . #
#### #####
#### #####
#### @####
##########

; 8
##########
##########
####.#####
### $ ####
##.$@$.###
### $ ####
####.#####
##########
##########
##########

; 10
##########
##########
##########
####.#####
##  $ ####
## # $.###
## # #####
## # #####
##   @####
##########

; 20
##########
##########
###   ####
### . ####
##  $#####
##   $.###
##    ####
##    ####
##   @####
##########

; 100
##########
###    . #
##       #
##    .  #
#####    #
#####  ###
##### $###
#####$ ###
#####@####
##########



; 101
##########
##       #
##.      #
##    .  #
####     #
####   ###
##### $###
#####$ ###
#####@####
##########



; 101
##################
#        #       #
#    @   #       #
#        #       #
#        #       #
#    $           #
#        #       #
#        #   .   #
#        #       #
##################

; 102
##################
#     ############
#     ############
#  .   ###########
#        #########
##   $   @   #####
###              #
####      $  .   #
########         #
##################