; 0
##########
###    . #
## .   $.#
##    .$ #
#####    #
#####  ###
##### $###
#####$ ###
#####@####
##########