; 1
##########
###.#   .#
# $ .. $ #
#@$    $##
######  ##
##########
##########
##########
##########
##########