; 2
##########
#####. ###
#####.   #
#####  $ #
##### $###
##### .# #
###   $  #
###    $@#
##     .##
##########