; 8
##########
##########
####.#####
### $ ####
##.$@$.###
### $ ####
####.#####
##########
##########
##########

; 8
##########
##########
#   .   ##
#   $   ##
#. $@$ .##
#   $   ##
#   .   ##
##########
##########
##########

; 7
##########
#### #####
####.#####
#### #####
####$#####
#### $ . #
#### #####
#### #####
#### @####
##########

; 8 Maybe with more iterations...
##########
##########
# . . . ##
#   $   ##
#   $   ##
#   $   ##
#   @   ##
##########
##########
##########